{
  "tiles" : [ [2, 1, 1, 0, 0, 0, 1, 1, 2 ],
              [1, 1, 1, 1, 1, 1, 1, 1, 1 ],
              [1, 1, 1, 1, 1, 1, 1, 1, 1 ],
              [1, 1, 1, 1, 1, 1, 1, 1, 1 ],
              [2, 2, 1, 1, 2, 1, 1, 2, 2 ],
              [1, 1, 1, 1, 1, 1, 1, 1, 1 ],
              [1, 1, 1, 1, 1, 1, 1, 1, 1 ],
              [1, 1, 1, 1, 1, 1, 1, 1, 1 ],
              [2, 1, 1, 0, 0, 0, 1, 1, 2 ] ],

  "targetScore" : 7200,
  "moves" : 15,
}
