{
  "tiles" : [ [2, 1, 1, 1, 1, 1, 1, 1, 2 ],
              [1, 2, 1, 1, 1, 1, 1, 2, 1 ],
              [1, 1, 2, 1, 1, 1, 2, 1, 1 ],
              [1, 1, 1, 2, 1, 2, 1, 1, 1 ],
              [1, 1, 1, 1, 2, 1, 1, 1, 1 ],
              [1, 1, 1, 2, 1, 2, 1, 1, 1 ],
              [1, 1, 2, 1, 1, 1, 2, 1, 1 ],
              [1, 2, 1, 1, 1, 1, 1, 2, 1 ],
              [2, 1, 1, 1, 1, 1, 1, 1, 2 ] ],

  "targetScore" : 16000,
  "moves" : 15,
}
