{
  "tiles" : [ [0, 0, 0, 0, 1, 0, 0, 0, 0 ],
              [0, 0, 0, 1, 1, 1, 0, 0, 0 ],
              [0, 0, 1, 1, 1, 1, 1, 0, 0 ],
              [0, 1, 1, 1, 2, 1, 1, 1, 0 ],
              [1, 1, 1, 2, 2, 2, 1, 1, 1 ],
              [0, 1, 1, 1, 2, 1, 1, 1, 0 ],
              [0, 0, 1, 1, 1, 1, 1, 0, 0 ],
              [0, 0, 0, 1, 1, 1, 0, 0, 0 ],
              [0, 0, 0, 0, 1, 0, 0, 0, 0 ] ],

  "targetScore" : 8000,
  "moves" : 20,
}
