{
  "tiles" : [ [0, 0, 0, 0, 0, 0, 0, 0, 0 ],
              [0, 1, 1, 1, 1, 1, 1, 1, 0 ],
              [0, 1, 0, 1, 1, 1, 0, 1, 0 ],
              [0, 1, 1, 1, 1, 1, 1, 1, 0 ],
              [0, 1, 1, 1, 1, 1, 1, 1, 0 ],
              [0, 1, 1, 1, 1, 1, 1, 1, 0 ],
              [0, 0, 1, 1, 1, 1, 1, 0, 0 ],
              [0, 0, 2, 2, 2, 2, 2, 0, 0 ],
              [0, 0, 0, 0, 0, 0, 0, 0, 0 ] ],

  "targetScore" : 14200,
  "moves" : 20,
}
