{
  "tiles" : [ [0, 0, 0, 0, 0, 0, 0, 0, 0 ],
              [0, 0, 0, 0, 0, 0, 0, 0, 0 ],
              [0, 0, 1, 1, 1, 1, 1, 0, 0 ],
              [0, 0, 1, 2, 1, 2, 1, 0, 0 ],
              [0, 0, 1, 1, 2, 1, 1, 0, 0 ],
              [0, 0, 1, 2, 1, 2, 1, 0, 0 ],
              [0, 0, 1, 1, 1, 1, 1, 0, 0 ],
              [0, 0, 0, 0, 0, 0, 0, 0, 0 ],
              [0, 0, 0, 0, 0, 0, 0, 0, 0 ] ],

  "targetScore" : 10200,
  "moves" : 15,
}
