{
  "tiles" : [ [0, 1, 1, 1, 1, 1, 1, 1, 0 ],
              [2, 1, 1, 1, 1, 1, 1, 1, 2 ],
              [1, 1, 2, 1, 1, 1, 2, 1, 1 ],
              [1, 1, 1, 1, 1, 1, 1, 1, 1 ],
              [1, 1, 1, 1, 0, 1, 1, 1, 1 ],
              [1, 1, 1, 1, 1, 1, 1, 1, 1 ],
              [1, 1, 2, 1, 1, 1, 2, 1, 1 ],
              [2, 1, 1, 1, 1, 1, 1, 1, 2 ],
              [0, 1, 1, 1, 1, 1, 1, 1, 0 ] ],

  "targetScore" : 6200,
  "moves" : 15,
}
